11111111111111111111111111111111
10111111111111110001001111111111
10000111111111100111011111111111
11110010111111100110011111111111
11000000000000000110111111111111
11111001111111110110111111111111
11111101111111110000111111111111
11111101111111111111111111111111
11111101111111111111111111111111
11111101111111111111111111111111
11111101111111111111111111111111
11111101111111111111111111111111
11111101111111111111111111111111
11110000011111111111111111111111
111100N0011111111111111111111111
11110000011111111111111111111111
11111111111111111111111111111111