1111111111
1011111111
1000011111
1111001011
1100000001
1111100111
1111110111
1111110111
1111110111
1111110111
1111110111
1111110111
1111110111
1111110111
1111000011
111100N011
1111111111