11111111111111111111111111111111
10111111111111110001001111111111
10000111111111100111011111111111
11110010111111100110011111111111
11000000000000000110111111111111
11111001111111010110111111111111
11111101111111010000111111111111
11111101111111000111111111111111
11111101111111100111111111111111
11111101111111000011111111111111
11111101111111100111111111111111
11111101111111100111111111111111
111111_1111111111111111111111111
1111N000011111111111111111111111
110]0000000111111111111111111111
1111000001-111111111111111111111
11111111111111111111111111111111