1111111111111111111111111
1000000000000000000000001
1000000000000000000000001
1000000000000000000000001
1000000000000000000000001
1000000000000000000000001
1000000000011000000000001
1000000000110111000000001
1000000000100001000000001
1000000000111111000000001
1000000000001000000000001
1000000000000000000000001
1000000000000000000000001
10000000000000n0000000001
1000000000000000000000001
1000000000000000000000001
1000000000000000000000001
1000000000000000000000001
100000000000N000000000001
1000000000000000000000001
1111111111111111111111111